6 5 5 4 4 4 4 4 4 4
6 6 6 6 5 5 4 4 4 4
5 3 5 6 4 5 4 4 4 4
4 4 4 6 6 6 6 6 4 4
4 4 4 5 5 4 5 6 6 6
3 4 5 4 4 4 5 4 4 6
3 4 4 4 4 4 4 4 6 6
2 4 4 4 4 4 4 6 6 4
5 4 4 4 4 4 4 6 4 4
4 4 4 4 4 4 4 6 6 6
